Large,
1111111111111111,
1111111111111121,
1001111111122110,
0111111221111111,
1122221122111122,
1111122111222111,
1112111121111111,
1111111111111111,
1111111111111111,
1111111111111111,
1111111111111111,
1111111111111111,
1111110