Large,
111112031111111,
111112031111112,
111112031111111,
111112031111111,
111112031111112,
111112031111111,
111112031111111,
111112031111111,
111111111111111,
111111111111111,
111111111111111,
111111111111111,
1111110