Large,
1111111111111111,
1111111111111111,
1111211111111111,
1112211111111112,
1222111111111122,
2221111111111222,
1111111111112222,
1111111111112211,
1111111111111111,
1111111111111111,
1111111111111111,
1111111111111111,
1111111111111111,
1111111111111111,
1111111111111111,
0