Large,
111111111111111,
111111111111111,
111221111111111,
112112111111111,
112112111111111,
112112111111111,
111221111111111,
111111111111111,
111111111111111,
111111111111111,
111111111111111,
111111111111111,
111111111111111,
111111111111111,
111111111111111,
111111111111111,
0