Large,
1111111111111111,
1111111111111111,
0001111111111110,
0011111111111111,
1111111111111111,
1111111111111111,
1111111111111111,
1111111111111111,
1111111111111111,
1111111111111111,
1111111111111111,
1111111111111111,
1111111111111111,
1111111111111111,
1111111111111111,
0