Large,
111111111111111,
111111111111111,
111111111111111,
111002111111111,
111332111111111,
111332111111111,
111332111111111,
111332111111111,
111111111111111,
111111111111111,
111111111111111,
111111111111111,
111111111111111,
111111111111111,
111111111111111,
111111111111111,
0