Large,
000001111111111,
000001122111111,
000001122111111,
000001122111111,
000001122111111,
000001111111111,
111111111111111,
111111111111111,
111111111111111,
111111111111111,
111111111111111,
111111111111111,
111111111111111,
111111111111111,
111111111111111,
111111111111111,
0