Large,
1111211111131111,
1112111111311111,
1121111113111111,
1211111131111111,
2111111111111112,
2211111111111111,
1111111111111111,
1111111111111111,
1111111111111110,
0111111111111100,
1111111111111111,
1111111111111111,
1111111111111111,
1111111111111111,
1111111111111111,
0