Large,
111113333331111,
111113333331111,
111113333331111,
111113333331111,
111113333331111,
111111111111111,
111113111131111,
111111111111111,
111113111131111,
111111111111111,
111113333331111,
111111111111111,
111111111111111,
111111111111111,
111111111111111,
111111111111111,
111111111111111,
111111111111111,
111111111111111,
111111111111111,
111111111111111,
111111111111111,
111111111111111,
111111111111111,
111111111111111,
111111111111111,
111111111111111,
111111111111111,
111111111111111,
111111111111111,
111111111111111,
111111111111111,
0