Large,
1111111111111111,
1111111111111111,
1111111111111100,
0000111111111011,
1101111111110111,
1011111111101111,
0111111111000000,
1111111111111111,
1111111111111111,
1111111111111111,
1111111111111111,
1111111111111111,
1111111111111111,
1111111111111111,
1111111111111111,
0