Large,
333333333333311,
311111111111311,
311111111111311,
311111111111311,
311111111111311,
311111111111311,
311100001111311,
311100001111311,
311111111111311,
311111111111311,
311111111111311,
311111111111311,
311111111111311,
311111111111311,
311111111111311,
333333333333311,
