Large,
333333333333333,
311111111111113,
311111111111113,
311111111111113,
311144441111113,
311144441111113,
311111111111113,
311100001111113,
311111111111113,
311111111111113,
311111111111113,
311111111111113,
311111111111113,
311111111111113,
311111111111113,
333333333333333,
