Tiny,
11111111,
11111111,
11100111,
11221101,
12211111,
22111112,
21133112,
211330