Large,
1111111221111111,
1111112211111111,
1111122111111111,
1111221111111111,
1112211111111111,
1122111111111111,
1221111111111111,
2211111111111111,
1111111111111111,
1111111111111111,
1111111111111111,
1111111111111111,
1111111111111111,
1111111111111111,
1111111111111111,
0