Large,
111111111111111,
111111111111111,
222211111111111,
222211111111111,
000011111111111,
111111111111111,
111111111111111,
111111111111111,
111111111111111,
111111111111111,
111111111111111,
111111111111111,
11111110