Large,
333333333333311,
111111111111111,
311111111111111,
111111111111111,
311111111111111,
111111111111111,
311111111111111,
111111111111111,
311111111111111,
111111111111111,
311111111111111,
111111111111111,
311111111111111,
111111111111111,
311111111111111,
111111111111111,
311111111111311,
111111111111111,
311111111111311,
111111111111111,
311111111111311,
111111111111111,
311111111111311,
111111111111111,
311111111111311,
111111111111111,
311111111111311,
111111111111111,
333333333333311,
111111111111111,
111111111111111,
111111111111111,
0